[
	[5,5,5,5,5,5,5,5,5,5,5,5,5,5,5,5,5,5,5,5,5,5,5,5,5,5,5,5,5,5,5,5,5,5,5,5,5,5,5,5,5,5,5,5,5,5,5,5,5,5]
	,[5,10,0,0,0,0,0,0,0,0,0,0,0,0,0,0,0,0,0,0,0,0,0,0,0,0,4,0,0,0,0,0,0,0,5,0,0,0,0,0,0,0,0,0,0,0,0,0,12,5]
	,[5,0,0,0,0,0,0,0,0,0,0,0,0,0,0,0,0,0,0,0,0,0,0,0,0,0,4,0,0,0,0,0,0,0,5,0,0,0,0,0,0,0,0,0,0,0,0,0,0,5]
	,[5,0,0,2,5,5,5,5,5,5,5,0,0,0,5,5,5,5,5,5,5,5,5,5,0,0,4,0,0,0,5,0,0,0,5,0,0,0,2,2,2,2,2,2,2,2,0,0,0,5]
	,[5,0,0,5,3,3,3,3,3,0,5,0,0,0,5,0,0,0,0,0,0,0,0,5,0,0,4,0,0,0,5,0,0,0,5,0,0,0,2,4,4,4,4,4,4,2,0,0,0,5]
	,[5,0,0,5,0,0,0,0,0,0,5,0,0,0,5,0,0,0,0,0,0,0,0,5,0,0,4,0,0,0,5,0,0,0,5,0,0,0,2,4,4,4,4,4,4,2,0,0,0,5]
	,[5,0,0,5,0,0,0,0,0,0,5,0,0,0,5,0,0,0,0,0,0,0,0,5,0,0,4,0,0,0,5,0,0,0,5,0,0,0,2,2,2,2,2,2,2,2,0,0,0,5]
	,[5,0,0,5,0,0,0,0,0,0,5,0,0,0,5,0,0,0,0,0,0,0,0,5,0,0,4,0,0,0,5,0,0,0,5,0,13,0,0,0,0,0,0,0,0,0,0,0,0,5]
	,[5,0,0,5,0,0,0,0,0,0,5,0,0,0,5,0,0,0,0,0,0,0,0,5,0,0,4,0,0,0,5,0,0,0,5,0,0,0,0,0,0,0,0,0,0,0,0,0,0,5]
	,[5,0,0,5,5,5,5,5,5,5,5,0,0,0,5,5,5,5,5,5,5,5,5,5,0,0,4,0,0,0,5,0,0,0,5,4,4,4,4,4,4,4,4,4,4,4,0,0,0,5]
	,[5,0,0,0,0,0,0,0,0,0,0,0,0,0,0,0,0,0,0,0,0,0,2,3,0,0,4,0,0,0,5,0,0,0,0,0,0,0,0,0,0,0,0,0,0,4,0,0,0,5]
	,[5,0,0,0,0,0,0,0,0,0,0,0,0,0,0,0,0,0,0,0,0,13,2,3,0,0,4,0,0,0,5,0,0,0,0,0,0,0,0,0,0,0,0,0,0,4,0,0,0,5]
	,[5,0,0,0,0,0,0,0,0,0,0,0,0,0,0,0,0,0,0,0,0,0,2,3,0,0,4,0,0,0,5,0,0,0,5,5,5,5,5,5,5,5,5,5,5,4,0,0,0,5]
	,[5,0,0,5,5,5,5,5,5,5,5,3,3,3,5,5,5,5,5,5,5,5,5,5,0,0,4,0,0,0,5,0,0,0,5,0,0,0,0,0,0,0,0,0,0,0,0,0,0,5]
	,[5,0,0,5,0,0,0,0,0,0,5,4,4,4,5,0,0,0,0,0,0,0,0,0,0,0,4,0,0,0,5,0,0,0,5,0,0,0,0,0,0,0,0,0,0,0,0,0,0,5]
	,[5,0,0,5,0,0,0,0,0,0,0,0,0,0,0,0,0,0,0,0,0,0,0,0,0,0,4,0,0,0,5,0,0,0,5,0,0,0,2,2,2,2,2,2,2,2,0,0,0,5]
	,[5,0,0,5,0,0,3,3,3,3,0,0,0,0,0,0,3,3,3,3,3,3,3,3,3,3,4,0,0,0,5,0,0,0,5,0,0,0,2,3,3,3,3,3,3,2,0,0,0,5]
	,[5,0,0,4,0,0,3,1,1,1,3,0,0,0,0,3,1,1,1,1,1,1,1,1,1,1,3,0,0,0,5,0,0,0,5,0,0,0,2,2,2,2,2,2,2,2,0,0,0,5]
	,[5,0,0,3,0,0,3,3,3,3,3,0,0,0,0,3,3,3,3,3,3,3,3,3,3,3,3,0,0,0,5,0,0,0,0,0,0,0,0,0,0,0,0,0,0,0,0,0,0,5]
	,[5,0,0,3,0,0,0,0,0,0,0,0,0,0,0,0,0,0,0,0,0,0,0,0,0,0,0,0,0,0,5,0,0,0,0,0,0,0,0,0,0,0,0,0,0,0,0,0,0,5]
	,[5,0,0,2,0,0,0,0,0,0,0,0,0,0,0,0,0,0,0,0,0,0,0,0,0,0,0,0,0,0,5,0,0,0,0,0,0,0,0,0,0,0,0,0,0,0,0,0,0,5]
	,[5,0,0,2,5,5,5,5,5,5,5,3,3,3,0,0,0,4,4,4,2,2,2,5,5,5,5,5,5,5,5,5,5,5,5,5,5,5,5,5,5,5,5,5,5,5,5,5,5,5]
	,[5,0,0,0,0,0,0,0,0,0,0,0,0,0,0,0,0,0,0,0,0,0,0,0,0,0,0,0,0,0,0,0,0,0,0,0,0,0,0,0,0,0,0,0,0,0,0,0,0,5]
	,[5,0,0,0,0,0,0,0,0,0,0,0,0,0,0,0,0,0,0,0,0,0,0,0,0,0,0,0,0,0,0,0,0,0,0,0,0,0,0,0,0,0,0,0,0,0,0,0,0,5]
	,[5,0,0,0,0,0,0,0,0,0,0,0,0,0,0,0,0,0,0,0,0,0,0,0,0,0,0,0,0,0,0,0,0,0,0,0,0,0,0,0,0,0,0,0,0,0,0,0,0,5]
	,[5,0,0,5,5,5,5,5,5,5,5,5,5,5,5,5,5,5,5,5,5,5,5,5,5,5,5,5,5,5,5,5,5,0,0,5,0,0,2,3,3,3,3,3,3,3,4,0,0,5]
	,[5,0,0,5,0,0,0,0,0,0,0,0,0,0,0,0,0,0,0,0,0,0,0,0,0,0,0,0,0,0,0,0,5,0,0,5,0,0,2,0,0,0,0,0,0,0,4,0,0,5]
	,[5,0,0,5,0,0,0,0,0,0,0,0,0,0,0,0,0,0,0,0,0,0,0,0,0,0,0,0,0,0,0,0,5,0,0,5,0,0,2,0,0,0,0,0,0,0,4,0,0,5]
	,[5,0,0,4,0,0,3,3,3,3,3,3,3,3,3,3,3,3,3,3,3,3,3,3,3,3,3,3,3,3,0,0,5,0,0,5,0,0,2,0,0,0,0,0,0,0,4,0,0,5]
	,[5,0,0,4,0,0,3,0,0,0,0,0,0,0,0,0,0,0,0,0,0,0,0,0,0,0,0,0,0,4,0,0,5,0,0,5,0,0,2,0,0,0,0,0,0,0,4,0,0,5]
	,[5,0,0,4,0,0,3,0,0,0,0,0,0,0,0,0,0,0,0,0,0,0,0,0,0,0,0,0,14,4,0,0,5,0,0,5,0,0,2,0,0,0,0,0,0,0,4,0,0,5]
	,[5,0,0,3,0,0,3,0,0,0,4,4,4,4,4,4,4,4,4,4,4,4,4,4,4,4,4,4,4,4,0,0,5,0,0,5,0,0,2,0,0,0,0,0,0,0,3,0,0,5]
	,[5,0,0,3,0,0,3,0,0,0,2,0,0,0,0,0,0,0,0,0,0,0,0,0,0,0,0,0,0,0,0,0,5,0,0,5,0,0,2,3,3,4,4,4,4,4,3,0,0,5]
	,[5,0,0,3,0,0,3,0,0,0,2,0,0,0,0,0,0,0,0,0,0,0,0,0,0,0,0,0,0,0,0,0,5,0,0,5,0,0,0,0,0,0,0,0,0,0,0,0,0,5]
	,[5,0,0,3,0,0,3,0,0,0,2,2,2,2,2,0,0,2,2,2,3,3,3,3,3,3,3,3,3,3,0,0,5,0,0,5,13,0,0,0,0,0,0,0,0,0,0,0,0,5]
	,[5,0,0,2,0,0,3,0,0,0,4,4,4,4,2,0,0,2,13,0,0,0,0,0,0,0,0,0,0,4,0,0,5,0,0,5,3,3,3,4,4,4,2,2,2,2,2,0,0,5]
	,[5,0,0,2,0,0,2,0,0,0,4,4,4,4,2,0,0,2,0,0,0,0,0,0,0,0,0,0,0,4,0,0,5,0,0,0,0,0,0,0,0,0,0,3,2,4,2,0,0,5]
	,[5,0,0,2,0,0,2,0,0,0,2,2,2,2,2,0,0,2,0,0,4,4,4,4,4,4,4,0,0,4,0,0,5,0,0,0,0,0,0,0,0,0,0,3,2,4,2,0,0,5]
	,[5,0,0,2,0,0,2,0,0,0,2,0,0,0,0,0,0,2,0,0,4,3,3,3,3,3,4,0,0,4,0,0,5,5,5,5,5,5,5,5,5,0,0,5,5,5,3,0,0,5]
	,[5,0,0,2,0,0,2,0,0,0,2,0,0,0,0,0,0,2,0,0,4,3,3,3,3,3,4,0,0,4,0,0,0,0,0,0,0,0,0,14,3,0,0,3,0,0,3,0,0,5]
	,[5,0,0,0,0,0,2,0,0,0,0,0,0,0,0,0,0,0,0,0,0,0,0,0,0,0,0,0,0,0,0,0,0,0,0,0,0,0,0,0,3,0,0,3,0,0,4,0,0,5]
	,[5,0,0,0,0,0,2,0,0,0,0,0,0,0,0,0,0,0,0,0,0,0,0,0,0,0,0,0,0,0,0,0,0,0,0,0,0,0,0,0,3,0,0,3,0,0,4,0,0,5]
	,[5,0,0,0,0,0,2,4,4,4,4,4,4,4,4,4,4,4,4,4,4,4,4,4,4,4,4,4,4,4,4,4,4,4,4,4,4,4,4,4,3,0,0,3,4,4,4,0,0,5]
	,[5,0,0,2,0,0,0,0,0,0,0,0,0,0,0,0,0,0,0,0,0,0,0,0,0,0,0,0,0,0,0,0,0,0,0,0,0,0,0,0,0,0,0,0,0,0,2,0,0,5]
	,[5,0,0,2,0,0,0,0,0,0,0,0,0,0,0,0,0,0,0,0,0,0,0,0,0,0,0,0,0,0,0,0,0,0,0,0,0,0,0,0,0,0,0,0,0,0,2,0,0,5]
	,[5,0,0,3,0,0,4,4,4,4,4,4,4,4,4,4,4,4,4,4,4,4,4,4,4,4,4,4,4,4,4,4,4,4,4,4,4,4,4,4,4,4,4,4,0,0,2,0,0,5]
	,[5,0,0,3,0,0,3,3,3,3,3,3,3,3,3,3,3,3,3,3,3,3,3,3,3,3,3,3,3,3,3,3,3,3,3,3,3,3,3,3,3,3,3,3,0,0,2,0,0,5]
	,[5,0,0,5,0,0,0,0,0,0,0,0,0,0,0,0,0,0,0,0,0,0,0,0,0,0,0,0,0,0,0,0,0,0,0,0,0,0,0,0,0,0,0,0,0,0,2,0,0,5]
	,[5,0,0,5,0,0,0,0,0,0,0,0,0,0,0,0,0,0,0,0,0,0,0,0,0,0,0,0,0,0,0,0,0,0,0,0,0,0,0,0,0,0,0,0,0,12,2,0,11,5]
	,[5,5,5,5,5,5,5,5,5,5,5,5,5,5,5,5,5,5,5,5,5,5,5,5,5,5,5,5,5,5,5,5,5,5,5,5,5,5,5,5,5,5,5,5,5,5,5,5,5,5]
];